            --------- 
            |..^^^^.| 
 -------    |..----+--
 |>....-------^|.....|
-----.0......|^|.....|
|...|-....--.|^|.....|
|.0.|..--....|^|.....|
|.0.|.0-----.|^|.....|
--.0.0.....|.|^|+----|
 |.0..0---.|.|^#zzz+$|
 |.|..0..|.|.|^|zzz|-|
 |.|.|.|...|.|^#zzz+$|
--.---...|.|.|^|zzz|-|
|..0..----.|.|^#zzz+$|
|....0....0....|------
----0..0|.0....|      
   |....|..-----      
   ---------          